######
#ABPB#
#S.B.#
#WGPB#
#S.BP#
######